R 600  400
NO ./textures/blue.xpm
SO ./textures/grey.xpm
C 45, 166, 166
WE ./textures/brick.xpm
EA ./textures/wood.xpm
S  ./sprites/sprite.xpm

F 83, 99, 99

1111111111111111111
1000000000000000001
1000000000000000001
1001111100020202001
1001000100000000001
1001020100020202001
1001000100000000001
1001101100020202001
1000000000000000001
1000000000000000001
1000000000000000001
1111111110000000001
1101000010000000001
1100002010000000001
11010000100000N0001
1101111110000000001
1100000000000000001
1111111110000000001
1111111111111111111